120 Monster|wN KM APNO EPRC
2006-June-26|wN KM APNO
A Good Bass for Gambling|fN KK APRC BASS EGTR
// A Long Day of Fun|zC BK AGTR APRC
A Mission|iN KM CLNT FLUT STRS TRBN TUBA
A Waltz For Naseem|fR DS APNO APRC CLNT GLCK HORN STRS
// Abrasive Accordion|zA BK ACDN APRC
Accralate|iC KM APRC MRBA
Aces High|iH KM APRC BASS EPNO JORG
Achaidh Cheide|iN KM APRC DULC HARP MDLN STRS WHSL
Achilles|iN KM APRC HORN STRS TRBN TRPT
Acid Beat|wN FN EPRC SYNZ
AcidJazz|iN KM APRC BASS EPNO MUTE
Acoustic Shifter|wN IM AGTR APRC SYNZ
Action Introduction|wA KK BELL EPRC SYNZ
Action Investigation|wC KK EPRC
Adding the Sun|fR KM APRC BASS EPRC VOCL
Adding the Sun|iR KM APRC BASS EPRC VOCL
Adventure|fH RK APRC HORN STRS
Adventures in Adventureland|iH KM APRC BASN BELL CLNT FLUT GLCK HARP HORN MRBA STRS TRBN TRPT TUBA
// African Rag|zH BK APNO APRC SYNZ
Against Time|sA SI APNO APRC BASS STRS SYNZ
Agnus Dei X|iS KM SB PORG VOCL
AhDah|iC KM EPNO EPRC JORG SYNZ VOCL
Air Prelude|iS KM FLUT SYNZ
// Air of Mystery and Suspense|bF BK APRC BASN BELL CLNT FLUT GLCK HARP HORN MRBA OBOE STRS TIMP TRBN TRPT TUBA
Airport Lounge|iH KM APRC BASS EPNO VIBE
Airship Serenity|iR KM SYNZ
Aitech|iH KM APRC BASS EGTR SYNZ
Al Andalus|sA SI AGTR APRC
Alien Restaurant|iC KM APRC BASS HARP OBOE SITR TRPT
Alison|wR JS APRC BASS EGTR
All The Tea In China|sC SI APRC ENST FLUT STRS
Allada|iN KM APRC MRBA
Almost New|iR KM APNO STRS
Almost in F|iC KM APNO STRS
Amazing Grace|fC KM JN SAXO
Amazing Grace 2011|iC KM JN APNO CLNT PORG
Ambient Bongos|fN AN APRC
Ambiment|iC KM APNO SYNZ
Americana|iR KM APRC CLNT CLST FLUT GLCK HORN OBOE STRS TIMP TRBN TUBA
Amunet Prime|sF SI SYNZ
Anachronist|iA KM EGTR EPRC HPCH
Anamalie|iS KM AGTR APNO APRC BASS CLNT OBOE
Ancient Mystery Waltz Allegro|iF KM APRC MRBA VOCL
Ancient Mystery Waltz Presto|iA KM APRC MRBA VOCL
Ancient Mystery Waltz Vivace|iF KM APRC MRBA VOCL
Ancient Rite|fS KM APRC STRS VOCL
Ancient Rite|iS KM APRC STRS VOCL
Ancient Winds|fC KM EFFX HARP STRS SYNZ
Ancient Winds|iC KM EFFX HARP STRS SYNZ
And Awaken|iC KM CLNT HARP HORN STRS
Andreas Theme|iR KM APRC BASS EPNO PFLT SYNZ
Angevin|iS KM APRC ENST FLUT VOCL
Angevin B|iN KM APRC ENST FLUT VOCL
AngloZulu|iH KM APRC FLUT HORN KLBA OBOE STRS TRBN TUBA VOCL
Anguish|iS KM AGTR APRC HARP SYNZ
// Another Sunny Day|zH BK APRC EGTR SYNZ
Apero Hour|iH KM AGTR APRC BASS JORG
Aquarium|fR KM CS APNO FLUT GLCK STRS
Aquarium|iR KM CS APNO FLUT GLCK STRS
Aquatic City Vanished|fN BT APRC FLUT STDR
Aretes|iR KM APNO SYNZ VOCL
Arid Foothills|iF KM APRC MRBA HORN STRS TRBN TUBA
Arpent|fH KM EPRC SYNZ
Artifact|iN KM AGTR APRC KLBA MRBA VOCL
As I Figure|iS KM AGTR APRC BASS EPNO SAXO
Ascending the Vale|iC KM APRC FLUT HARP HORN VOCL
Ashton Manor|iR KM CLNT FLUT HARP STRS
Asian Drums|iF KM APRC BELL
Asking Questions|fF RK APNO APRC BELL STRS SYNZ
At Launch|iN KM APRC CLNT FLUT HORN MUTE STRS TIMP TRBN TUBA
At The Shore|iC KM APRC BASS HORN VOCL
Aurea Carmina|iH KM BASS EGTR EPRC HORN STRS SYNZ TRBN TRPT
Autumn Day|iR KM AGTR APNO APRC BASS STRS VOCL
Avant Jazz|iF KM APRC BASS EPRC MUTE SAXO VIBE
Awaiting Return|iS KM GH APNO
Awesome Call|iH KM APNO APRC BASS EPNO
Awkward Apocalyptic Pickup|fF AY APRC CLNT FLUT STRS
Awkward Meeting|iF KM APNO SYNZ
BEES!|sH SI ACDN AGTR APRC SAXO SYNZ TUBA VIBE
BTS Prolog|wF KM STRS VOCL
Baba Yaga|iF KM APNO APRC SYNZ VOCL
Babylon|iC KM APNO APRC BASS FLUT GLCK SYNZ
Back To Cool|sN SI APRC BASS EGTR EPNO EPRC HPRC SAXO
Back on Track|iN KM APRC BASS
Backbay Lounge|iC KM AGTR APNO APRC BASS
Backbeat|fN KM EPRC SYNZ
Backed Vibes|iN KM BASS EFFX VIBE
Backed Vibes Clean|iN KM BASS VIBE
Bad Ideas _clean_|iF KM APNO
Bad Ideas _distressed_|iF KM APNO
Balloon Game|iH KM EPRC SYNZ
Balzan Groove|iA KM APRC EPRC STRS SYNZ
Bama Country|iH KM ACDN AGTR APRC BASS BNJO HMCA STRS
Bar Brawl|fH BT APRC DULC HPRC MDLN STRS WHSL
Barry The Badger|sH SI APNO BASN BASS FLUT HPCH
Basement Floor|iF KM EPRC SYNZ VOCL
Basic Implosion|iA KM EPRC HPRC SYNZ
Bass Meant Jazz|fN KM APRC BASS VIBE
Bass Soli|iC KM BASS
Bass Vibes|iN KM APRC BASS EPNO
Bass Walker|iN KM BASS
Bathed in the Light|iC KM SYNZ
Battle Ready|fF BT APRC DGOO ENWD HORN SYNZ TRBN TRPT TUBA
// Battle of the Desert Aliens|bF BK APRC DULC EGTR MRBA PFLT SYNZ VOCL
Be Chillin|fC AN AGTR APRC BASS EGTR JORG SYNZ
Beach Bum|iH KM APRC BASS EGTR
Beach Party|iH KM APRC BASS EGTR JORG STDR
Beachfront Celebration|iH KM APNO APRC BASS HORN STDR TRBN TRPT
Beauty Flow|iC KM APRC BASS SYNZ
Beginning of Conflict|fF RK APRC EPNO SYNZ
Behind the Sword|fN AN APRC BGPS ENST ENWD HARP STRS
Bicycle|iN KM BASS
Big Boi Pants|sA SI EPRC STRS SYNZ TIMP
Big Drumming|iN KM APRC
Big Eyes|fF RK BASN FLUT HARP OBOE PIZZ STRS
Big Mojo|iF KM APRC ENST FLUT STRS SYNZ TIMP TRPT
Big Rock|iA KM APRC BASS EGTR
Birch Run|iN KM APRC
Bit Bit Loop|fA KM EPRC SYNZ
Bit Shift|iH KM EPRC SYNZ
Black Bird|iN KM APRC HPRC
Blacksmith|fN AN APRC DGDO ENST SITR STRS
Bleeping Demo|iC KM APRC SYNZ
Blipotron|iF KM BASS EPRC SYNZ
Blipotron|wN FN EPRC SYNZ
Blippy Trance|fH KM EPRC SYNZ
Blippy Trance|iH KM EPRC SYNZ
Blobby Samba|iH KM BASS EFFX EPRC SYNZ
Blood Eagle|fF AN AGTR APRC FLUT VOCL WHSL
Blown Away|iA KM APRC SYNZ
Blown Away - No Percussion|iA KM SYNZ
Blue Feather|iS KM APNO
Blue Paint|iC KM APNO
Blue Ska|iH KM APRC BASS EGTR JORG SAXO TRBN TRPT
Blue Scorpion|iA KM APRC DULC EGTR EPRC KLBA SYNZ
// Blues 'n' Noise|zA BK AGTR APRC TUBA
Bollywood Groove|fF KM APRC ENST STRS VOCL
Bombay Summer|sF SI APRC BASS FLUT SITR STRS
Boogie Party|iH KM APNO APRC BASS JORG
Born Barnstomers|wH BB AGTR APRC BASS BNJO JORG MDLN
Boss Battle|wA KM APRC HORN STRS SYNZ TRBN
Bossa Antigua|iC KM AGTR APRC BASS
BossaBossa|iC KM AGTR APNO APRC BASS
Bossy Boots|sN SI APRC BASS EPNO JORG TRPT
Brandenburg Concerto III, Allegro I|fH DS JB SYNZ
Brandenburg No4-1 BWV1049|iR KM JB FLUT HPCH STRS
Breakdown|iN KM APRC BASS
Breathe|sF SI APNO EGTR SYNZ
Bright Ideas|sR SI APNO
Brightly Fancy|iH KM AGTR APRC BASS
Brittle Rille|iR KM BASS MUBX STRS
Broken Reality|iA KM APRC BASS EPRC SYNZ
Brothers Unite|fR AN APNO APRC HORN STRS
Building Inspiration|sH SI EPRC STRS SYNZ
Bumba Crossing|iC KM APRC BASS FLUT MRBA VOCL
Bummin on Tremelo|iR KM APRC BASS EGTR JORG VOCL
Burn The World Waltz |iA KM AN APRC BASS EGTR
Burning Trapezoid of Fire|fH KM APRC BASS EGTR
Burt's Requiem|fS AN APNO
Bushwick Tarantella|iH KM ACDN AGTR APRC BASS CLNT
Bushwick Tarantella Loop|iH KM ACDN AGTR APRC BASS CLNT
// C what I did There?|bC BK APRC BASN BELL CLNT FLUT HARP HORN GLCK MRBA OBOE PIZZ STRS TIMP TRBN TRPT TUBA
C-Funk|iH KM APRC BASS EGTR SAXO TRPT
Call to Adventure|iH KM APRC BASN CLNT CLST FLUT HORN MRBA OBOE STRS TIMP TRBN TRPT TUBA XYLO
Calm Sketch for Piano|wC KM APNO
Cambodian Odyssey|iC KM APRC FLUT OBOE SYNZ
// Can you Hear me Now?|bN BK APRC BASN BELL CLNT FLUT GLCK HARP HORN OBOE MRBA STRS TIMP TRBN TRPT TUBA
Canon In D For 8 Bit Synths|iH KM JP SYNZ
Canon In D Interstellar Mix|iH KM JP EPRC SYNZ
Canon in D Major|iR KM JP HARP STRS
Canon in D for Autoharp|iR KM JP DULC
// Canon in D for General MIDI Bass|zE BK JP BASS SYNZ
// Canon in D for General MIDI Brass|zE BK JP HORN MUTE TRBN TRPT TUBA
// TODO: adjust string format for my music
// Canon in D for General MIDI Chromatic Percussion|z@BK & JP|eBELL CLST DULC GLCK MRBA MUBX VIBE XYLO
// Canon in D for General MIDI Drums|z@BK & @JP|eAPRC BELL EPRC TIMP
// Canon in D for General MIDI Ensemble|z@BK & @JP|eSTRS SYNZ VOCL
// Canon in D for General MIDI Ethnic|z@BK & @JP|eBGPS ENST ENWD BNJO KLBA SITR STRS
// Canon in D for General MIDI Guitars|z@BK & @JP|eAGTR EGTR
// Canon in D for General MIDI Orchestral|z@BK & @JP|eHARP PIZZ STRS TIMP
// Canon in D for General MIDI Organs|z@BK & @JP|eACDN HMCA JORG PORG
// Canon in D for General MIDI Percussive|z@BK & @JP|eAPRC BELL EPRC STDR
// Canon in D for General MIDI Pianos|z@BK & @JP|eAPNO EPNO HPCH
// Canon in D for General MIDI Pipes|z@BK & @JP|eENWD FLUT PFLT WHSL
// Canon in D for General MIDI Reeds|z@BK & @JP|eBASN CLNT OBOE SAXO
// Canon in D for General MIDI Sound Effects|z@BK & @JP|eAGTR EFFX HPRC
// Canon in D for General MIDI Synth Effects|z@BK & @JP|eEFFX SYNZ
// Canon in D for General MIDI Synth Leads|z@BK & @JP|eSYNZ VOCL
// Canon in D for General MIDI Synth Pads|z@BK & @JP|eSYNZ VOCL
Canon in D for Two Harps|iR KM JP HARP
Canon in D for Two Renaissance Harps|iR KM JP HARP
Cantina Blues|iN KM APRC BASS ENST VOCL
Captain Scurvy|iN KM EPRC SYNZ
Careless Riot|wS KM FG APNO
Carpe Diem|iH KM AGTR APRC BASS CLNT CLST FLUT UKLE
Cartoon Battle|iA KM APRC MUTE SAXO TRBN TUBA
Cattails|iR KM ACDN AGTR BNJO ENST STRS
// Celebration Rock|z@BK|hAPRC EGTR SITR
Cello Suite 1 in G - Prelude|iN KM JB DULC
Celebration|fH AN AGTR APRC FLUT STRS
Celtic Impulse|iN KM APRC DULC HARP MDLN WHSL
Cephalopod|iA KM APRC GLCK HPRC SYNZ
Chaise De l’Obscurité|sA SI EGTR EPRC HARP STRS SYNZ
Champ de tournesol|fR KK AGTR
Chanter|iA KM APRC ENST SYNZ VOCL
Chase Pulse|iF KM SYNZ
Chase Pulse Faster|iF KM APRC SYNZ
Chase Pulse Faster|wF KM APRC SYNZ
Cheap Arp Guitar|wC AY AGTR
Chee Zee Beach|iH KM APRC BASS EGTR MRBA STDR
Chee Zee Cave|iA KM APRC HORN STRS TRPT
Chee Zee Caves V2|iA KM APRC STRS
Chee Zee Jungle|iF KM APRC DGOO FLUT KLBA MRBA VOCL
Chee Zee Lab|iN KM APRC EFFX EPRC SYNZ
Cheeky|sC SI APRC JORG SYNZ
Cheese Greater|sA SI EPRC STRS SYNZ
Cherry Blossom|iH KM APRC MRBA
Chicken Hut Bluegrass|sH SI APNO APRC BASS BNJO EGTR STRS
Chill|iC KM BASS EPRC SYNZ
// Chill Science|b@BK & @SI|cAPNO SAXO STRS
Chill Wave|iC KM BASS EGTR EPRC SYNZ
Chillectro|wN FN EPRC SYNZ
Chillin Hard|iC KM APRC SYNZ VOCL
Chipper Doodle|iH KM APNO EPRC SYNZ
Chipper Doodle v2|iH KM APNO EPRC SYNZ
Chrome Zone|sH SI EPRC SYNZ
Chronos|fN AN APNO EPRC SYNZ
Cipher2|iH KM EPNO EPRC STRS SYNZ
Circus Waltz FX|iH KM APNO
Circus of Freaks|fA KM APRC CLNT FLUT TRBN TRPT TUBA XYLO
Circus of Freaks|iA KM APRC CLNT FLUT TRBN TRPT TUBA XYLO
City Run|fA RK APRC
Clash Defiant|iA KM APRC HORN STRS TRBN VOCL
Clean Soul|iC KM BASS EPNO
Clear Air|iR KM AGTR APNO
Cloud Dancer|iH KM EPRC SYNZ VOCL
Club Diver|iA KM EPRC SYNZ
Club Seamus|iH KM BGPS EPRC SYNZ
Codename Dougwood|sA SI APRC FLUT HORN STRS TIMP TRBN TRPT
Cognitive Dissonance|iA KM EPRC SYNZ
Cold Funk|iN KM AGTR APRC BASS EPNO
Cold Journey|fS AN APNO APRC EFFX ENWD HARP HORN STRS
Cold Sober|iN KM AGTR APRC BASS BGPS EPNO
Colossus|iN KM APRC BASN BELL CLNT FLUT GLCK HORN MRBA OBOE TRBN TRPT TUBA
Comfortable Mystery|iS KM EPNO
Comfortable Mystery 2|iS KM EPNO
Comfortable Mystery 3|iS KM EPNO
Comfortable Mystery 4|iS KM EPNO
Comic Hero|iH KM APRC CLNT TRBN TUBA
Comin Round the Mountain|iH KM TR AGTR APRC BASS SYNZ
Comparsa|iH KM APNO APRC BASS EGTR FLUT SAXO TRPT
Concentration|iC KM EPNO SYNZ
Conflicted|iN KM APNO APRC CLNT HORN TIMP TRBN TRPT TUBA
Conflicted|wN KM APNO APRC CLNT HORN TIMP TRBN TRPT TUBA
Confused State|iF KM APRC BASN CLNT KLBA MRBA OBOE
Connecting Rainbows|fR KM HARP
Consecrated Ground|fF AN APNO APRC BELL PORG STRS TRBN
Consequence|iF KM APRC EPRC GLCK MRBA SYNZ
Consort for Brass|iR KM HORN TRBN TRPT TUBA
Constance|iF KM APRC MRBA STRS SYNZ XYLO
Cool Blast|iH KM BASS EPNO EPRC TRPT STRS
Cool Rock|iH KM APRC BASS EGTR
Corncob|iH KM APRC BASS BNJO
Court of the Queen|iR KM CLST HARP HORN PIZZ STRS TRBN TRPT TUBA
Covert Affair|iF KM APRC BASS EPNO TRPT
Cowboy Sting|iN KM AGTR APRC BASS ENST STRS
Coy Koi|fN AY APRC ENST
// Creepy Churchyard|b@BK & @PB|fACDN APRC BASN BELL CLNT EFFX FLUT HORN PORG STRS TIMP TUBA
Creepy Hallow|fF AN APNO CLST STRS SYNZ
Crinoline Dreams|iR KM APNO APRC BASS STRS
Crossing the Chasm|iA KM APRC STRS VOCL
Crossing the Chasm|wA KM APRC HORN STRS VOCL
Crowd Hammer|iF KM AGTR APRC ENST FLUT OBOE
Cruise Control|sH SI BASS EPNO EPRC SYNZ
Cruising for Goblins|iF KM EPRC SYNZ
Crunk Knight|iA KM ENWD EPRC SYNZ VOCL
Crusade|iS KM APRC HORN STRS TRBN TRPT
Crusade - Heavy Industry|iS KM APRC HORN STRS TRBN TRPT TUBA
Crypto|iF KM APRC FLUT SYNZ
Crystal Bungalow|wH KM VIBE
Cuban Sandwich|iN KM APNO APRC BASS
CumbiaNoFrills|iN KM AGTR APNO APRC BASS FLUT JORG SAXO TRPT
CumbiaNoFrillsFaster|iN KM AGTR APNO APRC BASS FLUT JORG SAXO TRPT
Cupids Revenge|iN KM EPRC STRS VOCL
Curse of the Scarab|iA KM APRC CLNT FLUT HORN OBOE STRS XYLO
Cut and Dry|iH KM APRC EPRC SYNZ
Cut and Run|iN KM EPRC HPRC SYNZ
Cyborg Ninja|iA KM EPRC SYNZ
DD Groove|iS KM AGTR APRC BASS JORG
Daily Beetle|iH KM AGTR APNO APRC HPRC MRBA MUBX UKLE
Dama-May|iF KM APRC DULC STRS
Dance Monster|iN KM APNO EPRC SYNZ
Dance of Deception|iF KM APRC PORG
Dance of the Turtle|wN KM BASN CLNT FLUT OBOE
Dances and Dames|iF KM APRC BASS EPNO VOCL
Dancing at the Inn|fH KM APRC ENWD HPCH TUBA
Danger Storm|iA KM AGTR APRC SYNZ
Dank Halloween|sA SI EPRC GLCK HPCH PORG STRS VOCL
Danse Macabre|iF KM CS APRC BASN CLNT FLUT HARP HORN OBOE PIZZ STRS TIMP TRBN TRPT TUBA XYLO
Danse Macabre - Isolated Harp|iR KM CS HARP
Danse Macabre - No Violin|iF KM CS APRC BASN CLNT FLUT HARP HORN OBOE PIZZ STRS TIMP TRBN TRPT TUBA XYLO
Danse Morialta|iR KM APNO
Danse of Questionable Tuning|iS KM APNO STRS
Dark 'n' Stormy|sA SI APRC BASS EGTR JORG SYNZ
Dark Dance|iF KM APNO FLUT GLCK STRS TIMP TRBN TUBA
Dark Flashes|sA SI BE APNO BASS EPRC FLUT SYNZ
Dark Fog|iS KM APRC SYNZ
Dark Pad|iC KM SYNZ
Dark Rock|wS KM APRC BASS EGTR EPNO
Dark Side Of Mars|sF SI EPRC SYNZ
Dark Star|iH KM APRC FLUT GLCK HORN STRS TRBN TRPT TUBA
Darkening Developments|iF KM APRC BASN CLNT EPRC FLUT OBOE STRS SYNZ
Darkest Child|iF KM CLST HARP STRS
Darkest Child var A|iF KM CLST HARP STRS
Darkness is Coming|iF KM EPRC SYNZ VOCL
Dawn of the Apocalypse|fF RK APRC STRS SYNZ VOCL
Daybreak|iC KM EPNO
Daytime TV Theme|iC KM APNO SAXO STRS
Dead Drop|iC KM APRC BASS EGTR
Deadly Roulette|iC KM APRC BASS EGTR HPRC SYNZ VIBE
// Decent Descent|b@BK|cAPRC BASN BELL CLNT FLUT GLCK HARP HORN MRBA OBOE STRS TIMP TRBN TRPT TUBA
Decisions|iF KM APRC EPRC STRS SYNZ VOCL
Deep Haze|iF KM APRC EGTR SYNZ
Deep Relaxation|fC KM APNO EFFX EPNO HARP SYNZ
Deep Relaxation|iC KM APNO EFFX EPNO HARP SYNZ
Deep Tones|fF KM HORN SYNZ TRBN
Del Rio Bravo|fH KM ACDN APRC BASS MRBA
Del Rio Bravo|iH KM ACDN APRC BASS MRBA
Delay Rock|iH KM APRC BASS EGTR
Deliberate Thought|iC KM SYNZ VOCL
Delightful D|iH KM EPRC SYNZ
Depth Of Focus|sS SI APNO STRS
Derp Nugget|iH KM APRC BASS DULC SYNZ
Desert City|iC KM APRC DULC
Desert Conflict|fF RK APRC ENST ENWD FLUT STRS SYNZ
Desert Fox|fF RK APRC ENST ENWD KLBA STRS
Desert Fox Underscore|fF RK APRC ENST ENWD KLBA STRS
Desert of Lost Souls|iF KM EPRC SYNZ
Destiny Day|iH KM APRC SYNZ
Deuces|iR KM APNO APRC BASS JORG
Devastation and Revenge|iF KM AGTR APRC HORN STRS SYNZ TRBN TRPT TUBA VOCL
Devonshire Waltz Allegretto|iR KM APNO APRC BASS CLNT FLUT HARP HORN PIZZ TRPT
Devonshire Waltz Andante|iR KM APNO APRC BASS CLNT FLUT HARP HORN PIZZ TRPT
Devonshire Waltz Moderato|iR KM APNO APRC BASS CLNT FLUT HARP HORN PIZZ TRPT
Dewdrop Fantasy|iC KM EFFX SYNZ
Diaphanous|sC SI SYNZ
Digital Lemonade|iH KM EPRC SYNZ
Digya|iN KM APRC BASS ENST MRBA
Dire Space Emergency|sF SI EPRC SYNZ
Dirt Rhodes|iC KM EPNO EPRC
Dirty Gertie|sA SI APRC BASS EGTR VOCL
Disco Lounge|iR KM APRC STRS SYNZ VIBE
Disco Medusae|iH KM BASS EGTR EPNO EPRC SYNZ
Disco Sting|iH KM EPRC SYNZ
Disco con Tutti|iH KM APRC EGTR EPNO SYNZ TRBN TRPT
Dispersion Relation|iN KM APNO APRC BASS FLUT TRPT VIBE
Distant Star|wN MF TM EPRC SYNZ
District Four|iA KM BASS EGTR EPRC JORG
Divertimento K131|iH KM WM BELL CLST HARP
Division|iF KM APNO APRC CLNT FLUT HORN OBOE STRS
Doh De Oh|iH KM APNO
Doobly Doo|iH KM APRC PIZZ SYNZ
Dopey Stroll Loop|wH KM APRC BASS JORG
Dopplerette|iF KM BELL SYNZ
Double Drift|iF KM AGTR APRC BASS SYNZ
Double O|iA KM EPRC JORG SYNZ VOCL
Double Polka|iH KM ACDN APRC TUBA
Down Home Rockin|iH KM APNO APRC BASS EGTR
Down the river|wH KK AGTR BNJO
Dragon Dance|wR RK APNO APRC HORN STRS VOCL
Dragon and Toast|iF KM APRC BASN CLST DGOO HARP OBOE STRS
Drankin Song|iC KM AGTR APRC BASS BNJO ENST STRS
Dream Aeterna|sF SI APRC BELL DULC EPRC STRS SYNZ VOCL
Dream Catcher|iF KM EPRC SYNZ VOCL
Dream Culture|iR KM APNO EPRC
Dream Freedom|wH DS APNO APRC BELL EGTR GLCK SYNZ TIMP
Dreamer|iC KM APNO APRC
Dreamlike|iF KM APNO BELL OBOE STRS SYNZ
Dreams of Vain|fF RK APNO APRC SYNZ
Dreamy Flashback|iR KM BELL HARP PIZZ
Dreamy Piano Fantasy|wC RK APNO APRC STRS VOCL
Driving Concern|fN KM APRC EPNO MRBA SYNZ
Drone in D|iC KM APNO SYNZ
Drop Point|fA BT APNO APRC MUTE SAXO TRBN TRPT
Drums of the Deep|iF KM APRC STRS
Dub Eastern|iF KM APRC BASS EGTR EPNO SYNZ
Dub Feral|iF KM APRC BASS EGTR EPNO SYNZ
Dubakupado|iN KM APRC MRBA
Dvorak Polka|iH KM ACDN APRC TUBA
// E-OPS|b@BK|nEPRC JORG SYNZ VOCL
EDM Detection Mode|iA KM EPRC SYNZ
Early Riser|iA KM EPRC HPRC SYNZ
Earnest|iS KM APNO
Earth Prelude|iC KM APNO BASN CLNT FLUT MRBA OBOE STRS SYNZ XYLO
Eastern Thought|iF KM APRC ENST STDR STRS
Eastminster|iC KM EFFX ENST STRS
Easy Jam|iS KM APRC BASS EGTR FLUT TRBN TRPT
Easy Lemon|iC KM AGTR APRC BASS CLST MRBA
Easy Lemon 30 second|iC KM AGTR BASS MRBA
Easy Lemon 60 second|iC KM AGTR APRC BASS CLST MRBA
Eb Demo|wN KM APNO EPRC
Ebbs and Flows|fC KM APNO EFFX SYNZ VOCL
Ebbs and Flows|iC KM APNO EFFX SYNZ VOCL
// Echinoderm|b@BK & @KM|fAPRC CLST EFFX SYNZ TRBN
Echoes of Time|iF KM BELL SYNZ
Echoes of Time v2|iF KM SYNZ
Ecossaise in E-flat|iH KM LB APNO
Egmont Overture|iN KM MO LB BASN CLNT FLUT HORN OBOE STRS TIMP TRPT
Egmont Overture Finale|iH KM MO LB BASN CLNT FLUT HORN OBOE STRS TIMP TRPT
Eighties Action|iN KM APRC SYNZ
El Magicia|iA KM AGTR APRC EGTR
Electro Cabello|iH KM EPRC SAXO SYNZ TRBN TRPT UKLE
Electro Sketch|iA KM EPRC SYNZ
Electrodoodle|iH KM EPRC SYNZ
Elf Meditation|fC KM EFFX HARP STRS SYNZ
Elf Meditation|iC KM EFFX HARP STRS SYNZ
Enchanted Journey|iR KM HARP
Enchanted Valley|iR KM CLNT CLST FLUT STRS
Energizing|fC KM APRC SYNZ
Energizing|iC KM APRC SYNZ
Enigma|iF KM APRC BASS EPNO SAXO STRS TRBN TRPT
Enter the Maze|iF KM APRC HORN SYNZ
Enter the Party|iN KM APRC JORG SYNZ
Envision|iF KM EGTR SYNZ
Equatorial Complex|iC KM EPNO SYNZ VOCL
Errigal|iH KM DULC
Eternity|iR KM APRC BASS EGTR EPNO SYNZ
Ether Disco|iH KM APRC BASS EGTR EPRC GLCK STRS
Ether Vox|iR KM APRC EGTR EPNO SYNZ VOCL
Ethereal Relaxation|iC KM STDR STRS
Ethernight Club|iN KM BELL EPRC MRBA SYNZ
Evening|iC KM AGTR OBOE STRS
Evening Fall - Harp|iS KM HARP
Evening Fall - Piano|iS KM APNO
Evening Melodrama|iH KM APRC CLNT FLUT HORN STRS TIMP TRBN TRPT
Ever Mindful|iC KM CLNT FLUT STRS VOCL
Exciting Trailer|iA KM APRC FLUT GLCK HORN STRS TRBN TRPT TUBA
Exit the Premises|iA KM APRC EPRC SYNZ
Exotic Battle|iA KM APRC FLUT HORN MRBA STRS TRBN TUBA XYLO
Exotics|iA KM APNO APRC EPRC SYNZ
Expeditionary|iF KM APRC FLUT KLBA STRS
Experimental Test Subject|fF KM APRC SYNZ
Eye of Forgiveness|fA RK APRC ENST STRS
Fairy Dance|wS RK CLST MRBA STRS
Fairytale Waltz|iS KM CLST OBOE STRS
Fanfare for Space|iH KM APRC HORN STRS TIMP TRBN TRPT
Fantasia Fantasia|iH KM EGTR EPRC SYNZ
Fantastic A|wS KM HARP OBOE STRS TIMP VOCL
Fantastic Dim Bar|iS KM APNO STRS
Fantastic Dim Bar|wS KM APNO STRS
Fantasy Overture|sF SI APRC BELL FLUT GLCK PIZZ STRS TRBN TRPT VOCL
// Far Out, Dude!|b@BK|cTODO
Fast Talkin|iF KM APRC BASS HORN STRS TRBN
Faster Does It|iA KM APRC BASS
Fearful New World|sF SI APNO SYNZ
Fearless First|iN KM BASS EGTR EPRC FLUT
Feel Good Feel|wH JS APRC BASS EPNO SYNZ
Feelin Good|iH KM APRC BASS EGTR JORG
Fenster's Explanation|fH KM APNO APRC CLNT FLUT TRBN SAXO TRPT TUBA
Fensters Explanation|iH KM APNO APRC CLNT FLUT TRBN SAXO TRPT TUBA
Feral Angel Waltz |iS KM AN APRC BASS EGTR
Fiddle-De-Dee|sH SI AGTR APRC MDLN STRS WHSL
Fiddles McGinty|iH KM AGTR APRC BASS BGPS WHSL
Fife and Drum|iH KM APRC FLUT
Fig Leaf Rag|iH KM SJ APNO
Fig Leaf Rag - distressed|iH KM SJ APNO
Fig Leaf Times Two|iH KM SJ APNO
Filthy|wF KK APRC BASS EGTR SYNZ
Finally See The Light|fH BT APRC BASS EPNO TRBN TRPT
Final Battle of the Dark Wizards|iF KM APRC EPRC HORN STRS SYNZ TRPT VOCL
Final Count|iF KM FC APNO APRC PORG TIMP TRBN VOCL
Final Step|fF RK APRC SYNZ
Finding Movement|iC KM ENST STRS
Finding the Balance|iN KM AGTR APRC BASS ENWD EPRC STDR SYNZ VOCL
Fire Prelude|iF KM APRC MRBA STRS SYNZ TIMP
Firebrand|iA KM APRC
Fireflies and Stardust|iR KM AGTR APRC BASS BNJO MDLN STRS
Firesong|iN KM APRC
Firmament|iN KM APRC BASS EGTR JORG
Five Armies|iA KM APRC CLNT FLUT HORN MRBA OBOE STRS TRBN TRPT XYLO
Five Card Shuffle|iH KM APNO
Flight Of The Swift|sN SI APNO APRC BASS BELL EGTR SYNZ
Floating Cities|iS KM APRC SYNZ
Fluffing a Duck|iH KM APRC CLNT FLUT MRBA TIMP TRBN TUBA
Fluidscape|iC KM FLUT HARP SYNZ
Flutey Funk|iN KM APRC BASS FLUT
Flying Kerfuffle|iH KM EPRC SYNZ
Folk Round|iN KM ACDN AGTR APRC FLUT STRS WHSL
Folk Song|wH BB AGTR APRC BNJO UKLE
For Originz|iR KM APRC STRS VOCL
Forest Frolic Loop|fH KM APRC BGPS DULC FLUT
Forest Night|fC PS APRC BELL EFFX HARP STRS SYNZ VOCL
Fork and Spoon|iH KM APRC BASS EPNO JORG
Four Beers Polka|iH KM ACDN AGTR APRC BASS CLNT EGTR SAXO TRPT
Fox Tale Waltz Part 1 Instrumental|iH KM APRC FLUT PIZZ STRS
Freddys Menagerie|iA KM AGTR APRC MRBA VOCL
Freezing Winds|wF KF AGTR EFFX SYNZ
Fright Night Twist|fF BT APRC BASS EGTR JORG TRPT
Frogs Legs Rag|fH KM JS APNO
Frogs Legs Rag|iH KM JS APNO
Frost Waltz|iF KM CLST FLUT GLCK HORN STRS
Frost Waltz (Alternate)|iF KM CLST FLUT GLCK STRS
Frozen Star|iC KM FLUT HARP TUBA VOCL
Fugue in Gee Miner|wN KM EPRC SYNZ
// Fugue of the Cat|b@BK|cAPRC BASN BELL CLNT EFFX FLUT GLCK HARP HORN MRBA OBOE STRS TIMP TRBN TRPT TUBA VOCL
Funeral March for Brass|iS KM APRC TRBN TRPT
Funin and Sunin|iH KM APRC BASS EGTR JORG
Funkeriffic|fN KM APNO APRC BASS EGTR JORG
Funky Boxstep|iH KM APRC BASS EGTR JORG
Funky Energy Loop|fN KM APRC BASS
Funky Chunk|iH KM APRC BASS EGTR EPNO SYNZ TRPT
Furious Freak|iA KM EPNO EPRC SYNZ
Future Cha Cha|iN KM BELL EPRC SYNZ VOCL
Future Gladiator|iA KM APRC BASS HPRC SYNZ
Fuzzball Parade|iH KM APRC PIZZ
Galactic Fandango|sN SI EGTR HORN SAXO STRS SYNZ TIMP TRBN TRPT
Galactic Rap|iC KM EPRC SYNZ
Galway|iH KM AGTR APRC BASS FLUT STRS
Gansta Badger|wN KM EPRC STRS SYNZ
Garden Music|iC KM APNO SYNZ
Gaslamp Funworks|iH KM APRC EFFX GLCK HORN STRS TRBN TRPT TUBA XYLO
George Street Shuffle|iH KM APNO APRC BASS VIBE
Germ Factory|wF IM EFFX SYNZ
Getting it Done|iH KM APRC SYNZ
Ghost Dance|iF KM APNO APRC FLUT HORN STRS
Ghost Processional|iS KM BELL CLST PIZZ STRS
Ghost Processional - Alternate|iS KM APRC BELL CLST EFFX PIZZ STRS
Ghost Story|iF KM APNO APRC VIBE
Ghost Town|fF RK AGTR APRC BASN BELL CLNT GLCK HARP HORN STRS XYLO
Ghost Town|wF RK AGTR APRC BASN BELL CLNT GLCK HARP HORN STRS XYLO
Ghostpocalypse - 1 Departure|iF KM SYNZ
Ghostpocalypse - 2 The Call|iF KM APNO APRC SYNZ
Ghostpocalypse - 3 Road of Trials|iS KM APNO SYNZ
Ghostpocalypse - 4 Temptress|iF KM APNO APRC SYNZ
Ghostpocalypse - 5 Apotheosis|iF KM EPRC SYNZ
Ghostpocalypse - 6 Crossing the Threshold|iS KM APNO BASS GLCK
Ghostpocalypse - 7 Master|iA KM APRC SYNZ
Ghostpocalypse - 8 Epilog|iS KM APNO
Give A Little|sH SI APNO APRC BASS SAXO TRBN TRPT
Glee Club Polka|iH KM AGTR APRC BASS CLNT EGTR SAXO TRPT
Global Resonance|wN KF APRC SYNZ
Gloom Horizon|iS KM APRC STRS
Gm115|wS KM APNO APRC SYNZ
Go Cart|iA KM EPRC SYNZ
Go Cart - Drop Mix|iA KM EPRC SYNZ
Go Cart - Loop Mix|iA KM EPRC SYNZ
Gonna Start|iH KM APNO APRC BASS EGTR JORG
Gonna Start v2|iH KM APNO APRC BASS EGTR JORG
Good Night|wS KM HORN STRS TRBN TRPT TUBA
Got Funk|iA KM APNO APRC BASS TRBN TRPT
Gotta Keep On Movin|fH BT APRC BASS EGTR EPNO STRS VOCL
Grand Dark Waltz Allegretto|iS KM APNO APRC BASS CLST FLUT HORN PIZZ TRPT
Grand Dark Waltz Allegro|iS KM APNO APRC BASS CLST FLUT HORN PIZZ TRPT
Grand Dark Waltz Moderato|iS KM APNO APRC BASS CLST FLUT HORN PIZZ TRPT
Grand Dark Waltz Trio Allegro|iS KM APNO APRC BASS
Grand Dark Waltz Trio Vivace|iS KM APNO APRC BASS
Grave Blow|iF KM STRS TIMP TRBN TUBA
Graveyard Shift|iF KM APRC JORG STRS SYNZ TIMP VOCL
Greko Sketch|iA KM APRC EPRC MDLN SYNZ VOCL
Grim Idol|iA KM APRC CLNT FLUT HORN JORG OBOE STRS TRBN
Griphop|iA KM EPRC STRS SYNZ VIBE
Groove Grove|iF KM APRC EPNO EPRC SYNZ
Groovin|fN BB APNO APRC EGTR JORG
Groovy Funky Disco|sH SI APRC BASS EGTR EPNO HORN HPRC STRS TRBN VOCL
Groundwork|iH KM AGTR APNO APRC BASS
Guess Who|iA KM APNO APRC BASN EGTR GLCK HPCH OBOE STRS
Gustav Sting|iA KM APRC STRS XYLO
Guts and Bourbon|iH KM APRC BASS EGTR MDLN
Guzheng City|iC KM APRC ENST
Gymnopedie No 1|iR KM ES APNO
Gymnopedie No 2|iR KM ES APNO
Gymnopedie No 3|iR KM ES APNO
Gypsy Shoegazer|iS KM AGTR APNO APRC HPRC TRBN VOCL
Gypsy Shoegazer No Voices|iS KM AGTR APNO APRC HPRC TRBN
HOLY MOLY|sA SI EPRC MRBA SYNZ
Hackbeat|iH KM AGTR APRC BASS
Half Mystery|iC KM EPRC SYNZ
Hall of the Mountain King|iA KM MO EG APRC BASN CLNT FLUT HORN OBOE PIZZ STRS TIMP TRBN TRPT TUBA
Halloween Theme 1|fF AN APNO CLST STRS SYNZ
Halls of the Undead|iF KM APRC BELL HORN OBOE PORG TIMP TRBN TUBA VOCL
Hand Balance Redux|iF KM APRC EPRC STRS SYNZ
Happy Bee|iH KM BASS EPRC JORG
Happy Bee - Surf|iH KM APRC BASS EGTR JORG
Happy Happy Game Show|iH KM APNO APRC BASS JORG TRPT
Hard Boiled|iC KM APNO APRC BASS
Harlequin|iN KM APNO CLNT
Harmful or Fatal|iA KM EGTR EPRC SYNZ
Healing|iC KM AGTR APRC FLUT STRS
Heart of Nowhere|iR KM STRS VOCL
Heartwarming|iR KM APNO
Heaven Is Free|wS KM FG EPRC MRBA PIZZ STRS VOCL
Heavy Heart|iS KM ENST STRS WHSL
Heavy Interlude|iA KM APRC DULC MDLN STRS
Helena's Lament|sS SI APNO
Hep Cats|iH KM AGTR APRC BASS EPNO FLUT JORG
Here We Go|wN AF APNO
Hexxit DRAVE Symphonie|wN YS HARP STRS
// TODO: more INST for ^^^ HDS ^^^
Hidden Past|iS KM APRC BGPS SYNZ
Hiding Your Reality|iF KM APRC HORN SYNZ TRBN TRPT TUBA
Highlight Reel|iN KM BASS EGTR EPRC HPRC SAXO TRPT
Hilary's Walk in the Woods|wN IM AGTR APRC EFFX
// TODO: more INST for ^^^ HWitW ^^^
Hillbilly Swing|fH KM AGTR BASS BNJO HPRC PIZZ
Hillbilly Swing|iH KM AGTR BASS BNJO HPRC PIZZ
Himalayan Atmosphere|iF KM APRC BELL
Hit the Streets|iA KM APRC
Hit the Streets v2|iA KM APRC
Honey Bee|iH KM APRC BASS EPNO TRPT
Honor Bound|fA BT APRC HORN STRS TRBN TRPT
Horned Flute Chill|wC KM AGTR APRC BASS EPNO FLUT GLCK HORN
Horns|fH KM APRC BASS EGTR TRBN TRPT
Horror_Spacial Winds|iC KM SYNZ
Hot Pursuit|iA KM APRC EGTR STRS
Hotrock|iA KM APRC BASS EGTR SAXO TRPT
How it Begins|iH KM APRC SYNZ
Human Beat|iN KM HPRC VOCL
Hustle|iH KM AGTR APRC BASS JORG
Hyperfun|iH KM APNO APRC UKLE TUBA
Hypnothis|iC KM EPRC SYNZ VOCL
I Can Feel it Coming|iF KM APRC EGTR SYNZ
I Domine|sA SI APRC EGTR EPRC HORN STRS TRBN TRPT VOCL
I Feel You|iR KM APNO BASS EGTR EPRC
I Got a Stick Arr Bryan Teoh|iH KM BT APRC BASS EGTR SAXO TRBN TRPT
I Got a Stick Feat James Gavins|iH KM BT JG APRC BASS EGTR SAXO TRBN TRPT VOCL
I Have The Power|sN SI APRC BASS EGTR STRS SYNZ
I Knew a Guy|iC KM APRC BASS VIBE
// I'm Afraid of Fears|z@BK|fAPRC EGTR EFFX TRPT VOCL
Ibn Al-Noor|iF KM APRC ENST
Ice Flow|iA KM APRC SYNZ
Ice and Snow|fS RK FLUT HORN STRS
Ignosi|iF KM APRC CLNT FLUT HORN MRBA STRS TRBN
Immersed|iC KM APNO
Impact Allegretto|iH KM AGTR APRC EGTR SYNZ
Impact Andante|iR KM APRC EGTR SYNZ VOCL
Impact Intermezzo|iA KM APRC
Impact Lento|iC KM SYNZ VOCL
Impact Moderato|iH KM APRC EGTR SYNZ
Impact Prelude|iF KM APRC EGTR SYNZ
Imperfect Echoes|wC KM APNO
Imperial China Cinematic|sR SI APRC ENST FLUT STRS
Impomptu in D Major|wH KM APNO
Impromptu for Pianoforte and Beatbox|wN KM BT APNO HPRC
In The West|iF KM APRC CLNT FLUT STRS
In Your Arms|iR KM APRC BASS MUTE SAXO TRBN
Industrial Cinematic|iF KM APRC SYNZ
Industrial Music Box|iS KM MUBX
Industrial Revolution|iS KM APRC HORN PORG STRS TRBN TRPT TUBA
Industrious Ferret|iH KM APRC ENST OBOE PIZZ
Inexorable|iF KM APNO EFFX
Infados|iF KM APRC KLBA MRBA STRS
Infinite Peace|fC KM APRC STRS XYLO
Infinite Perspective|iC KM APNO FLUT HARP HORN OBOE SYNZ VOCL
Infinite Wonder|fC KM SYNZ
Inner Light|iR KM APRC BASS DULC GLCK VOCL
Inspirational Breakthrough|sR SI APNO
Inspired|iC KM APRC EGTR SYNZ
Indended Force|wA KM CLNT GLCK HARP HORN STRS TIMP TRBN TRPT
Intended Force|iA KM CLNT GLCK HARP HORN STRS TIMP TRBN TRPT
Interluder|wF IM APRC EPRC FLUT SYNZ
// Interplanetary Mystery|b@BK|nFLUT HORN MRBA PIZZ STRS TRBN TRPT TRBN
// Interplanetary Mystery Electronic|b@BK|nSYNZ
Intractable|iS KM APRC BASS EPNO TRPT VIBE
Intrepid|iS KM APNO APRC STRS TRBN TUBA VOCL
Intuit256|iF KM APRC FLUT SYNZ
Invariance|iF KM APRC BASS MRBA XYLO
Iron Horse|iF KM APNO
Iron Horse - Distressed|iF KM APNO
Isolation Waltz|fR BT APNO HARP MUBX
It is Lost|iS KM SYNZ
It's Not Over 'Til The Bossa Nova|sC SI APRC BASS EGTR VOCL
Jalandhar|iA KM APRC BASS HPRC SITR SYNZ
Janus Turning|sA SI APRC BELL FLUT HORN PORG STRS SYNZ TRBN TRPT VOCL
Jarvic 8|iH KM BASS
Jazz Brunch|iR KM AGTR APRC BASS EPNO JORG
Jellyfish in Space|iC KM AGTR APRC BASS EPNO PFLT SYNZ
Jerry Five|iH KM EPRC HPRC SYNZ
Jet Fueled Vixen|iA KM APRC EGTR SYNZ
Jethro on the Run|fN AY AGTR APRC BASS BNJO MDLN STRS
Joey's Formal Waltz - Unscented|iR KM APRC BASS EGTR EPNO
Journey To Ascend|iC KM APRC STDR
Journey of Hope|fR AN AGTR APNO APRC EGTR STRS
Journey of Solitude|wS KM APRC FLUT STRS
Jungle Mission|fC RK APRC BASS CLST MRBA
Juniper|iC KM GH CLNT HARP HORN OBOE STRS TRBN TRPT TUBA
Junkyard Tribe|iA KM EPRC
Just As Soon|iS KM AGTR APRC BASS EPNO SAXO
Just Nasty|iA KM APRC EPNO JORG SAXO TRBN TRPT
K's Theme|wN DS APRC BASS EPNO SYNZ
Kalimba Relaxation Music|fC KM KLBA SYNZ
Kalimba Relaxation Music|iC KM KLBA SYNZ
Kawai Kitsune|iH KM EPRC SYNZ
Kick Shock|iA KM APRC EPRC SYNZ
Killers|iA KM APRC EGTR STRS VOCL
Killing Time|iF KM EPRC JORG SYNZ
Kings of Tara|iH KM AGTR APRC BASS BNJO FLUT
Kleine Bar|wR DS APNO APRC BASS EPNO FLUT HARP OBOE
Klockworx|iN KM EPRC SYNZ
Kumasi Groove|iC KM APRC MRBA
Kumasi Groove Flugelhorn|iC KM APRC MRBA TRPT
La Citadelle|fN KK AGTR BASS
La Pompe Du Trompe|sH SI AGTR APRC BASS
Laconic Granny|iS KM APRC CLNT TUBA
Lachaim|iH KM AGTR APRC BASS CLNT SAXO STRS TRBN
Laid Back Guitars|iS KM AGTR APRC
Land of Phantoms|iF KM APRC
Laser Groove|iN KM EPRC SYNZ
Laserpack|iA KM APRC EPRC SYNZ
Last Kiss Goodnight|iR KM APNO APRC BASS EGTR STRS
Lasting Hope|iS KM APRC HARP SYNZ VOCL
Late Night Radio|iC KM BASS EPNO EPRC SYNZ
Later Alligator|sA SI AGTR BASS EGTR EPRC
Latin Industries|iA KM APRC EPRC SYNZ VOCL
Latinish|wH FN APNO APRC BASS PLFT SAXO SYNZ
Lawful Victim Unit|wC KM APRC BASS EPNO STRS
Le Grand Chase|iA KM APNO APRC EFFX SAXO TRPT TUBA XYLO
Leaving Home|iS KM APNO CLNT DULC EGTR FLUT SYNZ
Legend of One|iF KM APNO EPRC SYNZ
Leopard Print Elevator|iR KM APRC BASS SYNZ
Lewis and Dekalb|iA KM EPRC SYNZ
Light Awash|iC KM SYNZ
Light Thought var 1|iC KM EPNO
Light Thought var 2|iC KM EPNO
Lightless Dawn|iS KM APRC BELL STRS SYNZ
Lift Motif|iR KM APNO
Limit 70|fC KM EPNO EPRC SYNZ
Limit 70|iC KM EPNO EPRC SYNZ
Lithium|iS KM APNO PORG STRS
Liturgy Of The Street|sF SI APRC EPRC STRS SYNZ
Lives That Are Worth Saving|wS KM FG EPRC SYNZ
Living Voyage|iN KM APRC ENST FLUT SYNZ VOCL
Lizzy|wH KM HPCH STRS
Lobby Time|iH KM APNO APRC BASS VIBE
Local Forecast|iN KM APNO APRC BASS EGTR EPNO FLUT TRPT
Local Forecast - Elevator|iN KM APNO APRC BASS EGTR EPNO FLUT TRPT
Local Forecast - Slower|iN KM APNO APRC BASS EGTR EPNO FLUT TRPT
Lone Harvest|iS KM APNO CLNT FLUT HARP STRS
Lonely Mountain|fS RK APRC FLUT HARP OBOE STRS TIMP TRPT TUBA
Long Road Ahead|iR KM APRC HORN STRS TIMP TUBA VOCL
Long Road Ahead B|iR KM STRS VOCL
Long Time Coming|iA KM APNO EPRC STRS SYNZ
Long Trail|wS BB AGTR APNO BASS STRS
Loopster|iN KM APRC BASS EPNO
Lord of the Rangs|iH KM APRC DGOO EPRC FLUT MRBA
Lost Frontier|iC KM APRC HORN STRS VOCL
Lotus|iN KM APRC
Love Song|iS KM APNO FLUT HARP HORN STRS
Low Level Action A|wF KM BASS
Lukewarm Banjo|fH KM AGTR APRC BASS BNJO
Lurking Sloth|fS AN APRC FLUT GLCK PIZZ TRBN TUBA
MJS Stings|iN KM AGTR APNO APRC BASS
Maccary Bay|iN KM BD APNO APRC BASS EGTR JORG
Machinations|iA KM APRC BASN OBOE STRS TRBN TUBA
Madness of Linda|fH RK APRC BASS EFFX HPRC MRBA VIBE XYLO
Magic Escape Room|iF KM APRC BASN BELL CLST EFFX FLUT GLCK HARP HORN OBOE PIZZ PORG STRS TIMP TRBN TUBA XYLO
Magic Forest|iC KM STRS SYNZ
Magic in the Garden|fC RK APRC CLNT CLST MRBA PIZZ
Magical Transition|fF KM CLST FLUT OBOE STRS
Magistar|iF KM EPRC GLCK SYNZ TRBN TRPT TUBA VOCL
Majestic Hills|iS KM APRC BELL CLNT FLUT GLCK HORN STRS TIMP TRBN TUBA
Mallet Chaos|wN KM APRC MRBA
Malt Shop Bop|iH KM APNO APRC BASS EGTR SAXO
Man Down|iS KM EPNO STRS
Manic Polka|iH KM ACDN APRC TUBA
Maple 100|fH KM SJ APNO
Maple Leaf Rag|fH KM SJ APNO
Maple Leaf Rag|iH KM SJ APNO
March of the Mind|iS KM APNO
March of the Spoons|iN KM APRC CLNT FLUT OBOE PIZZ
Martian Cowboy|iF KM BASS GLCK SYNZ
Mary Celeste|iF KM BASN BELL CLNT FLUT HORN MRBA OBOE STRS TUBA
Mascott's Theme|wH KK APRC BASS BNJO MDLN
Master Disorder|iF KM DULC EPRC SYNZ
Master of the Feast|iH KM AGTR APRC DULC ENST ENWD FLUT
Matts Blues|iH KM APRC BASS EGTR HMCA JORG
Meditating Beat|fC KM APNO APRC SYNZ
Mega Hyper Ultrastorm|iA KM EPRC SYNZ
Mellowtron|iC KM FLUT SYNZ
Merry Go|iH KM APNO
Merry Go - Distressed|iH KM APNO
Merry Go Slower|iH KM APNO
Merry Go Slower - Distressed|iH KM APNO
Mesmerizing Galaxy Loop|iF KM SYNZ
Metalmania|iA KM APRC BASS EGTR
Metaltania|wA KM APRC BASS EGTR
Metaphysik|iS KM APNO STRS SYNZ
Miami Nights - Extended Theme|iN KM APRC EPRC SAXO STRS SYNZ TRPT
Miami Viceroy|iC KM APRC BASS EGTR SYNZ
Midday Dance|iH KM APNO
Midnight Meeting|iS KM PORG
Midnight in the Green House|fS KM ENST STRS
Mighty Like Us|iH KM APRC SYNZ
Militaire Electronic|iA KM APRC EPRC
Mind Scrape|iF KM APRC BELL SYNZ
Minima|iF KM APRC BASN CLNT CLST FLUT HORN OBOE STRS TIMP TRBN TRPT VOCL
Minstrel Guild|iH KM APRC BAGP ENWD STRS WHSL
Mirage|iC KM SYNZ
Miris Magic Dance|iF KM ACDN APRC MDLN
Mischief Maker|iN KM APRC BASS DULC HPCH XYLO
Mistake the Getaway|iA KM APRC EPRC HORN STRS TRBN TRPT
Mister Exposition|iH KM APNO TUBA
Misuse|iF KM APRC EPRC SYNZ VOCL
// Modern Baroque|z@BK|nEPRC PORG
Modern Island Jam|fH KM SA APNO EPRC SYNZ
Modern Jazz Samba|iN KM AGTR APNO APRC BASS FLUT
Modern Piano Zeta - Improbable|iH KM APNO
Modern Vibes|iN KM VIBE
// Modulus|b@BK|hBASS EPRC STRS SYNZ VOCL
// Modulus (Ambient Mix)|b@BK|cSTRS SYNZ VOCL
// Modulus 2|b@BK|hBASS EPRC STRS SYNZ VOCL
// Modulus 2 (Ambient Mix)|b@BK|cSTRS SYNZ VOCL
// Modulus 3: Septembers|b@BK & Sepezz|sBELL EPNO EPRC STRS SYNZ VOCL
// Modulus 3: Septembers (Ambient Mix)|b@BK & Sepezz|sSTRS SYNZ VOCL
Monkoto|iN KM APRC CLNT MRBA
Monster Promenade|iH KM AGTR APRC JORG
Monsters in Hotel|fF RK APNO APRC GLCK HORN PORG TRBN TRPT XYLO
Montageur|wN FN EPRC SYNZ
Montauk Point|iH KM AGTR APRC BASS
Moon Lounge Omicron Prime|iH KM EGTR EPRC SYNZ
Moonlight Hall|iF KM APRC BASN CLST FLUT OBOE PIZZ STRS TIMP TUBA VOCL
Moonstone|iC KM APNO
Moorland|iS KM APRC BGPS
Morgana Rides|iF KM APRC DULC STRS SYNZ
Morning|iC KM AGTR FLUT HARP
Morning Snowflake|wR KM APNO
Morocco Sting|iN KM APRC BASN FLUT KLBA
Motherlode|iN KM APRC BASS EGTR HORN TRPT
Motivator|iH KM APRC BASS SYNZ
Mountain Emperor|iN KM APRC BELL
Mourning Song|iS KM OBOE STRS
Movement Proposition|iA KM APRC HORN STRS SYNZ TRBN
Murder On The Bayou|fF BT AGTR BASS BNJO EGTR HPRC
Music for Manatees|iC KM APNO EPNO STRS SYNZ
Myst|iS KM APRC CLNT FLUT OBOE STRS TRBN VOCL
Myst on the Moor|iF KM APRC FLUT MRBA SYNZ
Mysterioso March|iF KM APRC CLNT CLST HORN MUTE PIZZ
Mysterious Lights|fF BT APNO EPRC STRS
Mysterious String Quintet|sF SI DULC STRS
Mystery Sax|iF KM APRC SAXO SYNZ
Mystery Sting|iN KM APRC CLNT MRBA OBOE
Mystic Force|iN KM APRC BELL TUBA
Naraina|iA KM APRC BASS ENST EPRC TRPT
Native Dream|wN IM APRC STDR SYNZ
Neo Western|iN KM APRC EGTR SYNZ
Neon Laser Horizon|iH KM EPRC SYNZ
Neon Noir|sF SI EPNO EPRC SYNZ
Neptunian Princess|fF BT APNO APRC BASS MUTE OBOE VIBE
Nerves|iF KM APRC HORN STRS SYNZ TIMP TRBN TRPT
New Direction|iC KM SYNZ
New Friendly|iH KM EPRC SYNZ VOCL
New Hero in Town|fN KM APRC ENST
New Hero in Town|iN KM APRC ENST
News Theme|iH KM APRC HORN TIMP TRBN TRPT TUBA
NewsSting|iH KM APRC HORN SYNZ TRBN TRPT
Night Break|iF KM SYNZ
Night Cave|iC KM APRC KLBA MRBA
Night Drive|sN SI APRC BASS EGTR JORG
Night Vigil|fS KM APRC FLUT STRS VOCL
Night Vigil|iS KM APRC FLUT STRS VOCL
Night of the Owl|iF KM APRC FLUT
Night on the Docks|iS KM EPNO
Night on the Docks - Sax|iS KM EPNO SAXO
Night on the Docks - Trumpet|iS KM EPNO MUTE
Nightchaser|sN SI EPRC SYNZ
Niles Blues|iR KM APRC BASS EGTR JORG
No Frills Salsa|iH KM APNO APRC BASS TRBN TRPT
No Frills Salsa - Alternate|iH KM APRC BASS TRBN TRPT
No Rocking in the Jazzhands Zone|wS PG APNO
No Spam Polka|iH KM ACDN APRC TUBA
NoGoodLayabout|iH KM APNO APRC BASS CLNT
Noble Race|iN KM APNO BASN BELL CLNT FLUT GLCK HORN OBOE STRS TIMP TRBN TRPT
Noise Attack|iA KM BASS EGTR EPRC JORG
Nomadic Sunset|fN AN APRC EFFX ENST HARP STRS
Nomadic Sunset MMXIX|fR AN APNO APRC ENST STRS
Nonstop|iA KM EGTR EPRC SYNZ
Nordic Wist|fC KM ENST VOCL
Nostalgic Piano|fR RK APNO
Not As It Seems|iF KM APRC HARP GLCK HORN OBOE STRS TRBN TRPT TUBA
Notanico Merengue|iH KM APNO APRC BASS EGTR SAXO TRPT
Nothing Broken|iH KM AGTR APRC CLNT FLUT HPCH JORG
Novus Initium|fN AN APNO APRC STRS
Nowhere Land|iH KM APRC SYNZ
Numinous Shine|iC KM SYNZ
Obliteration|iA KM APRC HORN JORG STRS
Observe|sF SI SYNZ
Octave Jumper|wA FN EPRC SYNZ
OctoBlues|iR KM BD APRC BASS EGTR JORG
Odyssey|iH KM SYNZ
Olde Timey|iH KM APNO
Ominous Intro|iF KM SYNZ
On the Cool Side|iS KM APRC BASS EPNO SAXO TRPT
On the Ground|iF KM APRC BASS EPNO
On the Shore|iS KM FLUT GLCK STRS TIMP
One Sly Move|iS KM EGTR EPRC EPNO SYNZ
One With Everything|sC SI APRC EPRC FLUT ENST SITR SYNZ VOCL
One-eyed Maestro|iF KM ACDN APRC FLUT HORN STRS TRPT
Opening Move|sN SI APNO APRC BASS MUTE
// Operation Plot Summary|b@BK|nAPRC JORG PFLT TIMP TRPT VOCL
Opium|iC KM APRC DULC STRS VOCL
Opportunity Walks|iS KM APNO APRC BASS
Orchestra Demo|wC KM BELL CLNT HORN OBOE STRS TRBN TRPT TUBA
Organic Grunge|iA KM APRC EGTR JORG
Organic Meditations One|iC KM APRC BELL STRS
Organic Meditations Three|iC KM APNO STRS
Organic Meditations Two|iC KM HORN MRBA TUBA
Orion 300XB|iF KM APRC SYNZ VOCL
Orville Mulligan's Ragtime Dream|sH SI APNO APRC BASS CLNT EPRC MUTE SYNZ
Ossuary 1 - A Beginning|iC KM SYNZ
Ossuary 2 - Turn|iF KM APRC SYNZ
Ossuary 3 - Words|iF KM APRC SYNZ
Ossuary 4 - Animate|iF KM APRC EPRC SYNZ
Ossuary 5 - Rest|iC KM SYNZ
Ossuary 6 - Air|iF KM SYNZ
Ossuary 7 - Resolve|iC KM APRC SYNZ
Outdoors In Summer|sS SI AGTR APRC MUBX STRS
Ouroboros|iA KM EPRC SYNZ
Outfoxing the Fox|iN KM APRC BASS STRS SYNZ
Over Under|iC KM BASS
Overcast|iR KM APNO APRC BASS EGTR SYNZ
Overheat|iC KM FLUT STRS SYNZ
Overlander|sA SI APNO APRC BASS EGTR JORG
Overriding Concern|iF KM APNO BELL EPRC GLCK SYNZ VOCL
Overture|fH AN APRC CLNT HORN PIZZ STRS TIMP TRBN
Overture|iS KM APNO
Overworld|iF KM EPRC SYNZ
Padanaya Blokov|iN KM APRC BASS ENST EPRC SYNZ
Pagan Cross|sS SI WHSL
Pale Rider|iR KM HARP
Palm and Soul|fN KM SA APRC BASS EGTR JORG SAXO
Pamgaea|iH KM SYNZ
// Pan Flute Serenity|z@BK|cPFLT
Paradise_Found|iH KM EPRC STDR SYNZ VOCL
Passing Action|iF KM APRC BASS EPRC STRS
Patron Saint of Heists|fA BT APRC BASS EPNO FLUT SAXO
Peace in Sunlight|wN KF APRC SYNZ
Peace of Mind|iC KM APNO STRS SYNZ
Pennsylvania Rose|iH KM AGTR BELL FLUT HORN OBOE STRS TRBN
Peppy Pepe|iH KM APRC BASS EGTR SAXO TRBN TRPT
Perigrine Grandeur|iA KM APRC BASS DULC
Perspectives|iC KM AGTR APNO APRC FLUT GLCK STRS SYNZ
Petulant March|iN KM EPRC SYNZ
Phat Sketch|iN KM EPRC SYNZ
Phat Sketch|wN KM EPRC SYNZ
Phortitude|sN SI BASS EPRC STRS SYNZ
Piano Romantisme|sR SI APNO
Pilot Error|iN KM APNO APRC EGTR
Pinball Spring|iH KM EPRC SYNZ
Pinball Spring 160|iH KM EPRC SYNZ
Pixelland|iH KM EPRC SYNZ
Plain Loafer|iH KM APRC BASS EPRC
Pleasant Porridge|iC KM APRC BASS EGTR EPNO
Political Ad|iF KM SYNZ
Poofy Reel|iN KM AGTR APRC BASS EPNO
Porch Blues|iC KM AGTR APNO HMCA
Porch Swing Days - faster|iR KM AGTR APRC BASS VOCL
Porch Swing Days - slower|iR KM AGTR APRC BASS VOCL
Port Horizon|iN KM AGTR APNO APRC EFFX BASS STRS SYNZ TRBN TRPT VIBE
Posteriosis|sN SI EPRC SYNZ
Power Restored|iF KM APRC CLNT FLUT GLCK STRS TIMP TRBN TUBA
// Primer Post Braces|b@BK|nHPRC VOCL
Prefunk Loop|wN KM APRC BASS
Prelude in C - BWV 846|iR KM JB APNO
Presenterator|iH KM APRC SYNZ
Private Eye|iF KM APRC BASS HORN TRBN TRPT
Professor Umlaut|iA KM EPRC STRS XYLO
Professor and the Plant|iF KM BASN GLCK HARP MUTE
Proxima Centauri|sF SI APRC FLUT STRS SYNZ TRBN VOCL
Psychedelic Crater|iA KM EPRC SITR SYNZ
Psychedelic Crater|wA KM EPRC SITR SYNZ
Pulling The Plug On Kindness|wS KM FG APRC BASS VIBE
Pulse|wN KM APRC BASS EGTR
Pulse Rock|iN KM APRC BASS EGTR
Pump up your Graduation|fH KM JP EPRC SYNZ
Pure Attitude|iN KM EPRC HARP HORN STRS SYNZ TRBN TRPT
Pyro Flow|iA KM APNO APRC BASS SYNZ
// Questions of Time|z@BK|fEPNO HARP
Quiescent In Time|sC SI SYNZ
Quinns Song-A New Man|iS KM FC APNO TIMP STRS VOCL
Quinns Song-First Night|iF KM FC APNO SYNZ
Quinns Song-The Dance Begins|iS KM FC APNO STRS
Quirky Dog|iH KM APNO APRC BASS SYNZ TRPT
Radio Martini|iH KM AGTR APRC BASS CLNT FLUT PIZZ
Rain|wC DR EPRC SYNZ
Rain - remastered|wC DR EPRC SYNZ
Rainbows|iH KM APRC BASS MRBA UKLE
Rains Will Fall|iS KM APNO APRC STRS
Ranz des Vaches|iC KM GR BASN FLUT OBOE PIZZ
Raving Energy|iA KM EPRC SYNZ
Raving Energy (faster)|iA KM EPRC SYNZ
Raw|iN KM APRC BASS
Regency Baroque|sH SI HPCH STRS
Reggae (Sketch)|wA KM APRC EPNO JORG
Reggae Sketch|iA KM APRC EPNO JORG
Reign|iH KM APNO APRC EGTR HORN STRS VOCL
Relaxing Piano Music|iC KM APNO SYNZ
Release the Hybrids|fF BT EPRC STRS SYNZ
Relent|iS KM CLNT HARP
Remember This Shadow|wS KK AGTR APRC BASS UKLE
Rendezvous|sH SI APNO APRC BASS
Requiem: Titanic|wS DS BELL EFFX STRS SYNZ
RetroFuture Clean|iA KM APRC BASS EGTR JORG
Return of the Mummy|iF KM APRC ENST STRS VOCL
Reunited|iR KM APNO APRC STRS
Revival|iC KM APRC BASS EGTR EPNO VOCL
Ripples|iC KM ENST
Riptide|iH KM APRC BASS EGTR
Rising|iF KM APRC EPRC STRS SYNZ VOCL
Rising Game|iF KM APRC BASS EGTR HORN PORG STRS VOCL
Rising Tide|iC KM EPRC SYNZ
Rising Tide (faster)|iC KM EPRC SYNZ
Rites|iC KM HARP VOCL
Ritual|iS KM APRC FLUT SYNZ
River Flute|iC KM EFFX FLUT SYNZ
River Valley Breakdown|iH KM APRC BASS BNJO MDLN STRS
River of Io|iF KM APRC CLNT FLUT STRS SYNZ
Robo-Western|iA KM BASS EGTR EPRC STRS SYNZ
Robobozo|iF KM APRC EGTR JORG SYNZ
Rockapalooza!|sH SI APNO APRC BASS EGTR SAXO
Rocket|iA KM EGTR EPRC STRS SYNZ VOCL
Rocket Power|iA KM BASS EGTR EPRC JORG
Rollin at 5|iN KM APNO APRC BASS TRBN TRPT
Rollin at 5 - electronic|iN KM EPRC SYNZ
Roquefort Prolog|wC KM EPNO STRS
Round Drums|iN KM APRC
Royal Coupling|fR KM APRC CLNT FLUT HORN STRS TIMP TRBN TUBA
Royal Coupling|iR KM APRC CLNT FLUT HORN STRS TIMP TRBN TUBA
Run Amok|iH KM APRC BASN CLNT MRBA OBOE PIZZ TRBN TRPT TUBA
Rural Industry|fH KM APRC ENST OBOE PIZZ
Rush|fH RK APNO APRC BASS FLUT HPCH MUTE TUBA
Russian Microtheme|wF DS APRC ENST EPRC SYNZ
Rynos Theme|iF KM APNO APRC FLUT HORN STRS TRBN TUBA
Salty Ditty|iH KM EPRC SYNZ
Samba Isobel|iR KM APNO APRC BASS
Samovar Party|sA SI AGTR CLNT EPRC STRS SYNZ
Sancho Panza gets a Latte|iS KM ACDN AGTR APRC BASS FLUT TRPT
Sardana|iS KM AGTR
Satiate|iF KM EPRC STRS
Satiate Percussion|iF KM EPRC
Satiate Strings|iF KM STRS
Satin Danger|fF KM SYNZ VIBE
Savannah Sketch|iH KM APRC MRBA VOCL
Sax Rock and Roll|iA KM APRC BASS EGTR SAXO TRPT
Scattershot|iA KM APRC SYNZ
Scheming Weasel faster|iF KM APRC BASN BASS CLNT CLST GLCK OBOE
Scheming Weasel slower|iS KM APRC BASN BASS CLNT CLST GLCK OBOE
Schmetterling|iS KM PORG VOCL
Schmetterling|wS KM PORG VOCL
Scissors|iF KM APRC SYNZ
Screen Saver|fC KM SYNZ VOCL
Screen Saver|iC KM SYNZ VOCL
Second Coming - no percussion|iR KM HORN STRS TRBN
Secret of Tiki Island|iF KM BT AGTR APNO APRC BASS JORG VIBE VOCL
Secrets of the Schoolyard|iF KM EPRC SYNZ
Senbazuru|iC KM ENST FLUT STRS
Sergio's Magic Dustbin|iA KM APRC BASN CLNT FLUT GLCK HORN MRBA TRBN TRPT TUBA WHSL XYLO
Serious Showcase|wN KM APRC BASS SYNZ
Set It Up|sN SI APRC STRS SYNZ VOCL
Seven March|iF KM APRC SYNZ
Shades of Spring|iS KM APNO APRC BASS
Shamanistic|iF KM APRC FLUT STRS SYNZ XYLO
Shaving Mirror|iH KM APRC BASS EGTR JORG TRPT
Shaving Mirror|wH KM APRC BASS EGTR JORG TRPT
Shenyang|iH KM APRC ENST
Sheep May Safely Graze - BWV 208|iR KM JB CLST HARP MRBA VIBE
Shine|wF PS APNO APRC JORG STRS SYNZ
Shiny Tech|iH KM EPRC SYNZ
Shiny Tech2|iN KM EPRC SYNZ
Shores of Avalon|iS KM APNO SYNZ VOCL
Show Your Moves|iH KM EPRC SYNZ
Sidewalk Shade|iC KM APNO APRC BASS VIBE
Sidewalk Shade - slower|iC KM APNO APRC BASS VIBE
Signs To Nowhere|sF SI APRC BASS HORN MUTE SAXO VIBE
Silly Fun|iH KM BELL EPRC HPRC SYNZ WHSL
Silver Blue Light|iC KM AGTR SYNZ
// Simple EP Loop|z@BK|hEPNO EPRC VOCL
Simon Says Dont - 50 cents|iN KM SYNZ
Simon Says Dont - 50 cents|wN KM SYNZ
Simplex|iF KM AGTR APRC SYNZ
Sinfonia 3|iH KM BASS EPRC PORG
Sinfonia to Cantata 29|wH DS JB JORG SYNZ TIMP
Skill Is Futile|wN KM AGTR
Skipping in the No Standing Zone|wN PG APRC BASS EPNO MRBA
Skydive Safari|wH AY AGTR APRC BASS SYNZ
Skye Cuillin|iC KM HARP STRS SYNZ TIMP VOCL WHSL
Sleep_and_Then|iC KM BELL CLNT FLUT GLCK HARP STRS
Slide Kilter|sC SI AGTR BASS EPRC SYNZ VOCL
Slow Burn|iH KM APRC BASS EGTR JORG
Slow Heat|iC KM APRC MRBA
Slow Jam|iC KM APNO EPNO EPRC SYNZ
Smash Sketch|iA KM BASS EPRC EPNO JORG
Smoking Gun|iF KM APRC BASS BELL EGTR FLUT STRS VOCL
Smooth Lovin|iR KM AGTR APNO APRC BASS JORG
Smooth Move|iN KM EPRC SYNZ
Smooth it Out on the Whetstone of the Heavens|wS BP EPNO SYNZ
Smoother Move|iS KM APNO
Snap Happy|sH SI EPRC HRPC MRBA SYNZ VOCL
Snare Bounce Polka|iH KM ACDN APRC TUBA
Sneaky Adventure|iC KM APRC BASN BASS PIZZ
Snowdrop|iS KM APNO
Snowdrop|wS KM APNO
Soaring|iC KM SYNZ
Sober Scotsman|wN KM AGTR APRC BASS BGPS EPNO
Sock Hop|iR KM APRC BASS EGTR VIBE
Somewhere Sunny|iR KM AGTR
Somewhere Sunny (ver 2)|iR KM AGTR
Son Of A Rocket|iH KM APRC SYNZ
Sonata 17|iR KM APRC BASN FLUT HORN STRS TIMP TRBN TRPT TUBA
Song of the Volga Boatmen|iS KM TR HORN TRBN TRPT TUBA
Soporific|iS KM BELL EPNO EPRC
Southern Gothic|iF KM AGTR APRC BNJO HPRC VOCL
Soviet March|sF SI APRC BELL DULC ENST HORN STRS VOCL
Space 1990|iC KM APRC BELL SYNZ
Space 1990-B|iC KM APRC BELL SYNZ
Space Ambience|fC AN SYNZ
Space Explorers|wC KM FLUT SYNZ TRBN
Space Fighter Loop|iN KM APRC HORN SYNZ TUBA
Space Jazz|iH KM APRC JORG SYNZ
Spacedman|sC SI EPRC SYNZ
Spacial Harvest|iF KM SYNZ
Spacial Winds|wC KM SYNZ
Speakeasy|sH SI APRC BASS EFFX EGTR MUTE SAXO TRBN TUBA
Spec Ops|fA RK SYNZ
Spellbound|iF KM EGTR EPRC SYNZ VOCL
Spider Eyes|iF KM APNO BELL STRS
Spiders Web|iF KM HPCH STRS
// Spooky Dance Party|b@BK & @CS (mm. 44-51)|nAPRC BELL EFFX EPRC HORN HPCH PORG STRS SYNZ
Sports FM|sH SI APRC BASS EGTR JORG SYNZ TRPT
Spring Chicken|fH BT APRC FLUT GLCK PIZZ STRS XYLO
Spy Glass|iF KM APNO APRC FLUT HPRC MUTE SAXO VIBE
Spy Groove|iN KM APRC BASS EPNO JORG STRS
Stars and Laurels|sA SI APNO APRC STRS TRBN VOCL
Starting Out Waltz Allegretto|iR KM APNO APRC BASS
Starting Out Waltz Vivace|iR KM APNO APRC BASS
Stay the Course|iF KM APRC SYNZ
Stereotype News|fH RK APRC HORN STRS SYNZ TIMP
Stealth Groover|iC KM APNO APRC BASS EGTR SYNZ
Sticks and Tricks|wN KM APRC MRBA SYNZ
Still Pickin|fH KM ACDN APRC BASS BNJO HMCA STRS
Still Pickin|iH KM ACDN APRC BASS BNJO HMCA STRS
Stompin at Midnight|fH KM SA APRC BASS SAXO TRBN TRPT
Stompin at Midnight - Vinyl Recording|fH KM SA APRC BASS SAXO TRBN TRPT
Stoneworld Battle|iF KM APRC HORN STRS TIMP TRPT TUBA XYLO
Store Theme|wC KK APRC BASS BELL UKLE
Stormfront|iF KM APRC SYNZ
Street Party|iH KM APRC BASS JORG SAXO STDR TRBN TRPT WHSL
Streetlight On A Dark Road|iR KM OBOE
String Impromptu Number 1|iC KM STRS
Stringed Disco|iH KM APRC BASS EGTR EPNO STRS
Suave Standpipe|iR KM ACDN AGTR APRC BASS EPNO HORN JORG SAXO SYNZ TRBN TRPT TUBA VIBE
Sudden Defeat|iS KM APRC CLNT HORN TIMP TRBN TRPT TUBA
Sudden Defeat|wS KM APRC CLNT HORN TIMP TRBN TRPT TUBA
Summer Calypstep|sH SI APNO EPRC STDR SYNZ
Summer Day|iC KM AGTR APRC BASS EPNO
Summer Rain|sR SI APNO
// Summer Raingtone|b@BK & @SI|nAPNO EFFX
Summer Sidewalk|wH JS AGTR APRC BASS EPNO
Sun Up Gunned Down|fN BT AGTR APRC BASS BELL EGTR PFLT TRPT VOCL
Sunday Dub|fN KM APRC BASS EGTR JORG
Sunday Dub|iN KM APRC BASS EGTR JORG
Sunflower Dance Party|iH KM APRC HPRC SYNZ
Sunset at Glengorm|iS KM APNO SYNZ VOCL
Sunsetter|sN SI AGTR BASS EPRC SYNZ UKLE
Sunshine A|iH KM AGTR APNO APRC BASS
Sunshine ver 2|iH KM AGTR APNO APRC BASS
Super Friendly|iH KM APRC EPNO SYNZ VOCL
Super Polka|iH KM APRC BASS CLNT EGTR TRPT
Super Power Cool Dude|iH KM APRC BELL SYNZ
Surf Inspector|iN KM APRC BASS EGTR EPNO JORG
Surf Shimmy|iN KM APRC BASS EGTR JORG
Suspended Animation|sF SI APNO APRC SYNZ
Swimmey Texture|iC KM APNO SYNZ
Swing Has Swung|sA SI APNO APRC BASS SAXO TRBN TRPT VIBE
Swing Maching|fN KM SA APNO EPRC SAXO SYNZ TRPT
Symbiosis|iF KM APNO EPRC
Symmetry|iF KM EPRC SYNZ
Synapse|sC SI EPRC SYNZ
Synergy Cruiser|wH KM APRC BELL SYNZ
Tabuk|iF KM APRC FLUT STRS
Tafi Maradi|iH KM APRC VOCL
Tafi Maradi no voice|iH KM APRC
Tango de Manzana|iR KM ACDN APNO APRC BASS FLUT STRS
Take a Chance|iH KM APRC BELL CLNT FLUT HORN STRS TIMP XYLO
Take the Ride|fN BT APRC BASS EGTR JORG SYNZ VOCL
Take the Lead|iA KM APRC BASS EGTR SYNZ
Tape Star|sC SI EPRC SYNZ
Tapped Piano|wS KM APNO
Tatami Tea|wC KM ENST ENWD SYNZ
Tea Roots|iC KM APNO APRC BASS EGTR ENST JORG MUTE SAXO
Tech Live|iH KM APRC KLBA SYNZ
Tech Talk|iH KM BASS EGTR EPRC SAXO TRPT XYLO
Tech Talk|wH KM BASS EGTR EPRC SAXO TRPT XYLO
Tectonic|iA KM APNO APRC HORN STRS TIMP TRBN TRPT
// Temple Jazz|z@BK|sAPRC PFLT TRBN
Temple Ruins|wF KM APRC BELL
Temple of the Manes|iS KM APRC FLUT HARP OBOE
Tempting Secrets|iC KM FLUT STRS VOCL
Tenebrous Brothers Carnival - Act One|iF KM APRC CLNT GLCK JORG STRS TUBA VOCL
Tenebrous Brothers Carnival - Act Three|iF KM APRC STRS
Tenebrous Brothers Carnival - Act Two|iF KM AGTR APRC PORG
Tenebrous Brothers Carnival - Intermission|iF KM APRC SYNZ
Tenebrous Brothers Carnival - Mermaid|iF KM APRC BELL CLST HARP VOCL
Tenebrous Brothers Carnival - Prelude|iF KM APRC EPRC JORG SYNZ
Tenebrous Brothers Carnival - Snake Lady|iC KM APRC ENWD
Thatched Villagers|iH KM AGTR APRC DULC WHSL
That Zen Moment|iC KM STDR STRS
Thats a Wrap|iC KM APRC BASS SYNZ
Thaxted|iR KM GH BASN CLNT FLUT HARP HORN OBOE STRS TRBN TRPT TUBA
The Britons|fC KM AGTR APRC WHSL
The Buccaneer's Haul|sN SI APRC BELL HORN STRS TRBN VOCL WHSL
The Builder|iF KM APRC BASN MRBA OBOE PIZZ TRBN TRPT TUBA
The Cannery|iH KM APNO APRC EFFX MUBX TRPT
The Celebrated Minuet|fR RK RB PIZZ STRS
The Celebrated Minuet for Piano|fR RK RB APNO
The Chamber|iF KM APRC CLNT HARP HORN STRS TRBN TIMP VOCL
The Complex|iA KM APNO EPRC SYNZ
The Crown|fN AN APNO APRC BASN HARP OBOE PIZZ STRS
The Curtain Rises|iH KM APRC HORN STRS TIMP TRBN TUBA
The Cutest Bunny|sH SI AGTR APRC BASS GLCK STRS UKLE VOCL XYLO
The Drama|fF RK APRC STRS SYNZ
The Entertainer|fH KM SJ APNO
The Entertainer|iH KM SJ APNO
The Escalation|iF KM APRC STRS
The Forest and the Trees|iC KM CLNT FLUT GLCK TRBN
The Ginger Girl|wS AY APRC CLNT GLCK HORN STRS TRBN XYLO
The Good Fight|sS SI PORG STRS VOCL
The Hidden Valley of Shambhala|wS KM AGTR STRS
The Lift|iN KM EPRC SYNZ
The Machine Thinks|iF KM SYNZ
The Medieval Banquet|sC SI APRC DULC ENST HARP WHSL
The Modal Drummer|wH KM APRC MRBA
The Other Place|sF SI EPRC SYNZ
The Other Side of the Door|iN KM FLUT HARP OBOE PIZZ STRS
The Path of the Goblin King|iF KM CLNT CLST FLUT OBOE PIZZ TIMP
The Path of the Goblin King v2|iF KM CLNT CLST FLUT OBOE PIZZ TIMP
The Pyre|iN KM APRC MDLN STRS
The Range|fH RK APRC HORN STRS
The Right Direction|sH SI APRC EGTR SYNZ
The Rule|iH KM BELL HORN TIMP TRBN TRPT TUBA
The Second Coming|iF KM LV WY APRC HORN STRS TRBN VOCL
The Second Coming - Instrumental|iF KM APRC HORN STRS TRBN
The Snow Queen|iF KM BASN CLNT CLST FLUT PIZZ STRS TIMP
The Story|fS AN APNO APRC HORN STRS XYLO
The View Across|wC KM APRC BASS ENST
The Vikings|fN AN APNO APRC STRS VOCL
The Way Out|iF KM APRC SYNZ
The Whip Theme|iA KM APRC BASS EGTR EPRC
The Whip Theme (Extended Version)|iA KM APRC BASS EGTR EPRC
The Wonders Of Science|sH SI EPRC SYNZ
There It Is|iN KM BASS EGTR EPRC TRBN TRPT
Thief in the Night|iC KM APRC BASS EGTR JORG
Thin|wH KM APRC BASS EGTR
Think About It|fS BT APNO STRS SYNZ
Thinking Out Loud|iN KM APNO APRC EPRC STRS SYNZ TIMP
Through The Woods|sH SI CLNT CLST FLUT HARP PIZZ
Thunder Dreams|iS KM SYNZ
Thunderbird|iC KM APRC FLUT SYNZ
Thunderhead|iN KM APRC
Tiki Chanter|wF KM APRC HORN VOCL
Tikopia|iN KM APRC
Time Passes|iS KM APNO FLUT HARP HORN STRS
Time Travellin' Nancy|sH SI APNO BASS EPRC VOCL
Timewarp|wC BX BASS EPRC SYNZ
Tiny Fugue|iN KM PORG
To the Ends|iS KM BASN BELL CLNT OBOE STRS TRBN VOCL
Tonight At Eight|sH SI APRC EPRC HORN STRS TRBN SYNZ
Tranquility|iC KM SYNZ
Tranquility Base|iC KM BELL SYNZ
Transition One|iC KM BELL CLNT FLUT GLCK HARP STRS
Tremendum|sA SI EPRC STRS SYNZ VOCL
Triangle|wR JS AGTR APNO APRC BASS EPNO SAXO SYNZ
Trio for Piano Violin and Viola|iS KM APNO STRS
Trip Up North|fH BT AGTR APRC BASS EGTR
Trips It|iA KM FC APRC BASS EPNO SYNZ VOCL
Trouble with Tribals|iA KM APRC SYNZ VOCL
Truth of the Legend|iF KM APRC SYNZ TRBN VOCL
Twisted|iN KM APRC BASS EGTR EPNO
Twisting|iA KM APRC BASS EGTR EPRC SYNZ
Two Finger Johnny|iH KM BASS EPRC JORG
Two Guns, One Destiny|sN SI APRC BELL EGTR GLCK HMCA HORN STRS TIMP TRPT VOCL WHSL
Tyrant|iA KM EPRC SYNZ
Ultra Polka|iH KM EPRC SYNZ
Ultralounge|iR KM APNO APRC BASS SYNZ
Umbrella Pants|iF KM APRC GLCK PIZZ
Unanswered Questions|iF KM ENST
Undaunted|iA KM APNO EPRC SYNZ
Underglow|sF SI SYNZ
Unfolding Mirrors|sS SI APNO STRS SYNZ
Unity|iA KM APNO EPRC KLBA
Universal|iR KM APNO BASS EPRC SYNZ
Unnatural Situation|iF KM APNO SYNZ
Unpromised|iS KM APRC FLUT HARP VOCL
Unrelenting|iF KM STRS VOCL
Unwritten Return|iF KM APNO EPNO EPRC SYNZ
Upbeat Forever|iH KM APRC BASS EGTR SAXO TRBN TRPT
Urban Gauntlet|iN KM AGTR APRC KLBA SYNZ
// Vacation in Lovers' Leap|z@BK|rAGTR APRC BASS SYNZ VOCL
Vadodora|iN KM APRC ENST FLUT SITR SYNZ
Vadodora Chill Mix|iN KM APRC FLUT SITR SYNZ
Valse Gymnopedie|iR KM ES APNO APRC
Vanes|iS KM EPNO EPRC HARP SYNZ
Vanishing|iF KM APNO CLNT FLUT HORN OBOE STRS SYNZ TRBN TUBA
Variation on Egmont|iA KM LB APNO EPRC SYNZ
Vegas Glitz|iH KM APRC SAXO TRBN TRPT
Verão|sH SI ACDN APRC BASS EGTR SYNZ TRPT
Vibe Ace|iH KM APRC BASS SYNZ VIBE
Vibing Over Venus|iC KM AG RE APNO APRC BASS STRS VIBE
Vicious|iH KM EPRC SYNZ
Village Consort|iH KM AGTR APRC PFLT WHSL
Village Dawn|iH KM APNO
Virtutes Instrumenti|iS KM STRS
Virtutes Vocis|iS KM VOCL
Vivace Momentum|fR KM SA STRS
Vivacity|iH KM APRC BASS JORG VIBE
Voice Over Under|iH KM APRC HPRC SYNZ
Void Glider|sF SI SYNZ
Volatile Reaction|iA KM APRC BASN CLNT FLUT HORN STRS TRBN TUBA
Voltaic|iA KM EPRC SYNZ
Vulcan|iF KM APRC BELL FLUT
Wagon Wheel|iH KM APRC
Wagon Wheel - Electronic|iH KM EPRC SYNZ
Waiting on Platform 9|wF IM EPRC SYNZ
Wallpaper|iH KM AGTR APRC SYNZ
Wallpaper Paste|sH SI APNO APRC HPRC MUTE SYNZ TUBA
Walk Happy|sH SI AGTR APRC EGTR EPNO
Walking Along|iC KM APRC BASS VIBE
Waltz - Tschikovsky Op. 40|iS KM PT APNO
Waltz Primordial |iS KM AN APRC BASS EGTR
Waltzing Marvin|wR AY AGTR APRC BASS STRS
Water Droplets on the River|iR KM APNO
Water Prelude|iR KM BASN BELL CLST FLUT HARP STRS
Waunobe March|iH KM APRC CLNT FLUT GLCK SAXO TRBN TRPT TUBA
We Got Trouble|iF KM APRC BASN CLNT FLUT HORN STRS TIMP TRBN TRPT TUBA
Weight of Responsibility|iS KM HORN STRS TRBN TRPT TUBA
Welcome to the Show|iH KM APRC BASS EGTR SYNZ TRPT XYLO
Well-tempered Raver|wA AY JB EPRC SYNZ
Wepa|iN KM BASS EPRC STRS
Werq|iH KM EPRC SYNZ
Western Streets|iF KM APRC BELL TIMP
Wet Riffs|iC KM BASS
What Is Love|iR KM EPRC STRS SYNZ
What You Want|iA KM APRC BASS EGTR VOCL
What You Want ver 2|iA KM APRC BASS EGTR
What's The Angle?|sN SI APRC BASS MUTE
Whimsy Groove|iH KM APRC MRBA
Whiskey on the Mississippi|iH KM APRC BASS EGTR EPNO JORG
White|iR KM APNO
White Lotus|iC KM APNO DULC STDR SYNZ
Who Likes to Party|iH KM APRC EGTR HORN STRS SYNZ
Wholesome|iH KM APRC MRBA PIZZ
Willow and the Light|iS KM APRC FLUT HARP VOCL
Wind of the Rainforest|fC KM EPNO HARP SYNZ
Wind of the Rainforest|iC KM EPNO HARP SYNZ
Windswept|iR KM AGTR STRS
Windy Old Weather|fH KM TR ACDN
Windy Old Weather - thin|fH KM TR ACDN
Winner Winner|iH KM APRC GLCK PIZZ STRS VOCL XYLO
Winter|fR AN APNO
Winter Chimes|iR KM APNO
Winter Reflections|iC KM SYNZ
Wisdom in the Sun|fC KM BASS BELL EGTR
Wisps of Whorls|iC KM EPNO SYNZ
Witch Hunt|iA KM APRC CLNT FLUT HORN KLBA OBOE STRS TRBN TUBA
Witch Waltz|fF KM APRC CLNT HARP STRS
With Regards|iR KM AGTR TRBN TUBA
With a Creation|iF KM EPNO EPRC
Wizard Circus|fN KM SA APRC HORN TRBN TRPT TUBA
Womp|sA SI APRC SYNZ
Wonder Flow|wN KM APRC BASS SYNZ
Wood and Metal and Water|iC KM APRC BELL MRBA STRS SYNZ
World Vice|iA KM AGTR APRC MRBA VOCL
Xenon Sentry|sA SI EPRC SYNZ
You, Yourself and the Main Character|wC KK EGTR
Your Call|iN KM APRC BASS EGTR STRS SYNZ
Zanzibar|iH KM APRC MRBA VOCL
Zap Beat|iA KM APRC BASS EGTR JORG SYNZ
Zazie|iH KM APRC BASS EPNO TRPT VOCL
Zebra Township|sH SI ACDN AGTR APRC BASS TRPT VOCL
Zen Garden|sN SI BELL ENST EPRC GLCK SYNZ
ZigZag|iN KM APRC BASS EGTR SYNZ
Zombie Chase|iF KM APNO APRC SYNZ
a432|wC KM APNO STRS
// celestial claws|b@BK|nAPNO APRC BASN BELL CLNT CLST FLUT GLCK HARP HORN MRBA OBOE PIZZ STRS TIMP TRBN TRPT TUBA VIBE XYLO
space explorers|iC KM FLUT SYNZ TRBN
// TODO: filter all STRS and check for PIZZ
